7 14

# map
# . - grass
# t - trees
# * - water
# h - hills
# M - mounteens

 . . * . . . *
. . . t . M . 
 . . . . . . .
. . . . . . . 
 . . . . . . .
. . . . . . . 
 . . . . . * .
. . * * * . . 
 . * h h * . .
. * h M h * . 
 . * h h * . .
. . * * * . . 
 . . . . . . .
. . . . . . . 

